25 78
19 19 19 19 19 19 19 19 19 19 19 19 19 19 19 19 19 19 19 19 19 19 19 19 19
19 19 19 19 20 19 19 19 19 19 19 19 19 19 19 19 19 19 19 19 19 19 19 19 19
19 19 20 20 00 20 20 20 20 19 19 19 19 19 19 19 19 19 19 19 19 19 19 19 19
19 19 00 00 00 00 00 00 00 20 19 19 19 19 19 19 19 19 19 19 19 19 19 19 19
19 19 00 00 00 06 06 06 01 00 20 20 20 20 20 19 19 19 19 19 19 19 19 19 19
19 19 18 01 00 06 06 06 00 00 00 00 00 00 00 20 19 19 19 19 19 19 19 19 19
19 19 19 00 00 06 06 06 00 00 00 02 00 00 02 00 20 19 19 19 19 19 19 19 19
19 19 19 00 02 06 06 06 00 00 00 02 00 02 00 00 00 20 19 19 19 19 19 19 19
19 19 19 00 00 06 06 06 06 00 00 00 00 00 00 01 00 00 20 20 20 19 19 19 19
19 19 19 00 00 06 06 06 06 00 00 00 06 06 06 06 06 00 00 00 00 20 19 19 19
19 19 19 01 00 00 06 06 06 06 06 06 06 06 06 06 06 06 06 06 00 00 19 19 19
19 19 19 18 00 00 06 06 06 06 06 06 06 06 06 06 06 06 06 06 06 00 19 19 19 
19 19 19 19 02 00 00 06 06 06 06 06 06 00 00 00 00 06 06 06 06 00 19 19 19 
19 19 19 19 18 02 00 00 00 00 00 00 00 00 00 01 00 00 06 06 06 00 19 19 19 
19 19 19 19 19 00 00 01 01 00 00 00 00 01 02 02 00 00 06 06 06 00 20 19 19 
19 19 19 19 19 18 00 02 02 02 00 01 00 01 02 02 00 06 06 06 06 00 00 19 19 
19 19 19 19 19 19 18 18 00 02 00 00 00 00 00 01 00 06 06 06 06 00 00 19 19 
19 19 19 19 19 19 19 19 18 18 18 00 00 00 00 00 00 06 06 06 00 18 18 19 19 
19 19 19 19 19 19 19 19 19 19 19 18 18 00 02 00 06 06 06 06 00 20 19 19 19 
19 19 19 19 19 19 19 19 19 19 19 19 20 00 00 00 06 06 06 00 00 18 19 19 19 
19 19 19 19 19 19 19 19 19 19 20 20 00 02 00 00 06 06 06 00 00 19 19 19 19 
19 19 19 19 19 19 20 19 20 20 00 00 00 00 00 00 06 06 06 00 18 19 19 19 20 
19 19 19 19 19 19 00 20 00 02 00 00 01 00 00 00 06 06 06 00 19 19 19 20 03
19 19 19 19 19 19 18 00 00 00 01 00 00 00 01 06 06 06 06 18 19 19 20 04 03
19 19 19 19 19 19 19 00 00 00 00 00 00 00 00 06 06 06 00 19 19 20 03 03 05
19 19 19 19 19 19 19 00 00 00 00 02 00 00 06 06 06 06 00 19 19 03 05 03 03
19 19 19 19 19 19 19 18 00 02 00 00 06 06 06 06 06 06 18 19 20 03 03 03 05
19 19 19 19 19 19 19 20 00 00 00 06 06 06 06 06 06 00 20 19 05 03 04 03 03
19 19 19 19 19 19 19 18 00 00 06 06 06 06 06 06 00 00 00 20 03 03 03 03 03
20 19 19 19 19 19 19 19 18 00 06 06 06 00 00 00 00 03 03 03 05 03 03 03 04
03 20 19 19 19 19 20 20 20 00 06 06 00 00 03 05 03 04 03 03 03 03 03 03 03
03 04 20 19 20 20 03 03 04 03 24 24 03 03 03 03 03 03 03 05 03 03 03 05 03
03 03 03 20 03 03 03 03 03 05 24 24 03 04 03 03 05 03 03 03 03 03 03 03 03
03 03 03 05 03 03 03 05 03 03 24 24 03 03 03 03 03 03 03 03 05 03 03 03 05
03 03 04 03 03 03 03 03 03 03 24 24 05 03 03 03 03 03 05 03 03 03 03 05 03
03 03 03 03 03 04 03 03 03 04 24 24 03 03 04 03 03 03 03 03 03 03 04 03 03
03 03 03 05 03 03 03 03 03 03 24 24 03 03 03 03 04 03 05 03 03 03 03 03 03
03 03 03 03 03 03 05 03 05 00 06 06 00 03 03 03 03 03 03 03 03 03 03 03 03
03 03 04 03 04 03 03 03 00 06 06 06 02 00 05 03 03 03 03 03 03 05 03 03 03
03 05 03 03 03 03 03 00 00 06 06 00 00 00 03 03 04 03 03 03 03 03 05 03 03
03 03 03 03 03 05 03 00 06 06 06 00 00 01 03 03 03 03 05 03 05 03 03 03 03
03 03 03 04 03 03 03 00 06 06 06 01 00 00 00 00 03 03 03 03 03 03 03 03 04
03 05 03 03 03 05 03 00 06 06 06 00 02 00 18 00 00 03 03 03 03 03 04 03 03
03 03 03 03 04 03 02 00 06 06 06 00 00 00 20 02 18 00 03 04 03 03 03 05 03
03 03 04 03 03 02 01 00 06 06 06 00 00 00 00 00 20 00 00 03 03 03 03 05 03
05 03 03 03 00 00 00 00 06 06 06 00 01 00 00 01 00 00 00 02 03 04 03 03 03
03 03 04 18 00 00 00 06 06 06 06 06 00 02 00 00 00 00 01 00 03 03 03 05 03
18 18 18 19 00 00 06 06 06 06 06 06 06 00 00 02 01 00 00 02 00 03 03 03 03
19 19 19 20 00 06 06 06 06 18 06 06 06 06 00 00 18 18 00 00 00 03 04 03 03
19 19 19 00 00 06 06 06 18 19 18 06 06 06 06 00 20 20 18 00 01 00 00 03 05
19 19 19 00 00 06 06 06 19 19 19 06 06 06 06 06 00 00 20 18 18 18 00 00 18
19 19 19 18 00 06 06 06 19 19 19 06 06 06 06 06 06 00 00 20 20 20 18 00 19
19 19 19 19 00 06 06 06 20 19 20 06 06 06 18 06 06 06 00 00 18 00 20 18 19
19 19 19 19 00 06 06 06 06 20 06 06 06 06 19 18 06 06 06 00 19 18 00 20 20
19 19 19 19 00 00 06 06 06 06 06 06 06 00 20 20 06 06 06 00 19 20 18 00 00
19 19 19 19 00 00 00 06 06 06 06 03 03 04 05 03 03 06 06 00 19 00 20 18 18
19 19 19 19 18 00 00 03 24 24 24 05 18 18 18 18 04 24 24 00 20 18 18 20 20
19 19 19 19 19 00 04 03 06 06 06 00 20 20 20 20 00 06 06 05 03 20 20 00 00
20 19 19 19 19 03 03 00 06 06 06 06 06 06 06 06 06 06 00 00 03 00 00 18 18
03 20 20 20 19 03 18 00 06 06 06 06 06 06 06 06 06 06 00 00 03 05 00 20 20
03 03 03 03 20 05 20 00 06 06 06 06 06 06 06 06 06 00 01 01 00 03 03 00 00
05 03 03 03 04 03 00 00 00 06 06 06 00 00 00 00 00 00 02 02 00 18 04 03 03
03 03 04 03 03 03 05 00 00 06 06 06 00 00 00 18 18 18 18 18 18 20 00 18 18
03 03 03 03 04 03 03 03 03 00 00 00 05 03 03 20 20 20 20 20 19 18 00 19 20
03 03 03 05 03 03 05 03 00 00 00 00 00 04 03 03 03 00 00 00 19 19 18 20 18
03 04 03 03 03 04 03 03 00 00 00 00 00 03 03 05 03 04 00 00 20 20 20 00 20
05 03 03 05 03 00 00 00 00 00 00 00 00 00 00 00 03 03 04 03 03 03 03 00 00
03 03 05 03 00 00 00 00 00 00 00 00 18 00 00 00 00 05 03 03 04 03 03 03 03
03 03 03 03 00 00 00 00 00 00 00 00 20 00 00 00 00 03 05 03 03 03 05 03 03
04 03 04 03 00 00 00 00 00 00 00 00 00 00 00 00 00 03 03 03 03 03 03 03 03
03 03 03 03 00 00 00 00 00 18 00 00 00 00 00 00 00 05 03 04 03 03 03 04 03
03 05 03 04 00 00 00 00 00 20 00 00 00 00 00 00 00 03 03 03 05 03 03 03 03
03 03 03 03 00 00 00 00 18 00 00 00 00 00 00 00 00 05 03 03 03 03 04 03 03
03 03 03 03 00 00 00 00 20 00 00 00 00 00 00 00 00 03 03 03 03 03 03 05 03
03 03 05 03 03 00 00 00 00 00 00 00 00 18 00 00 03 03 03 03 04 03 03 03 03
04 03 03 03 03 04 03 00 00 00 00 00 00 20 03 03 03 04 03 03 03 03 03 03 04
03 03 04 03 03 03 03 05 00 00 00 00 00 03 03 05 03 03 05 03 03 03 05 03 03
05 03 03 03 05 03 03 03 03 04 03 03 05 03 04 03 04 03 03 03 04 03 03 03 03