25 50
19 19 19 19 19 19 19 19 19 19 19 19 19 19 19 19 19 19 19 19 19 19 19 19 19
19 19 19 19 19 19 19 19 19 19 19 19 19 19 19 19 19 19 19 19 19 19 19 19 19
19 19 20 20 20 20 19 19 19 19 19 19 19 19 19 19 19 19 19 19 19 19 19 19 19
19 19 06 06 06 00 19 19 19 19 19 19 19 19 19 19 19 19 19 19 19 19 19 19 19
19 19 06 06 06 00 19 19 19 19 19 19 19 19 19 19 19 19 19 19 19 19 19 19 19
19 19 06 06 06 00 19 19 19 19 19 19 19 19 19 19 19 19 19 19 19 19 19 19 19
19 19 06 06 06 00 20 19 19 19 19 19 19 19 19 19 19 19 19 19 19 19 19 19 19
19 19 06 06 06 00 00 20 20 19 19 19 19 19 19 19 19 19 19 19 19 19 19 19 19
19 19 06 06 06 06 01 00 00 20 20 20 20 20 19 20 20 19 19 19 19 19 19 19 19
19 19 18 06 06 06 06 06 06 06 06 06 06 06 20 00 00 20 19 19 19 19 19 19 19
19 19 19 06 06 06 06 06 06 06 06 06 06 06 06 02 00 00 19 19 19 19 19 19 19
19 19 19 18 06 06 06 06 06 06 06 06 06 06 06 06 00 00 20 19 19 19 19 19 19
19 19 19 19 18 01 18 06 06 06 00 18 18 18 06 06 06 00 00 20 19 19 19 19 19
19 19 19 19 20 00 19 06 06 06 00 19 19 19 00 06 06 06 02 00 19 19 19 19 19
19 19 19 19 00 18 19 06 06 06 00 19 19 19 18 00 06 06 06 00 19 19 19 19 19
19 19 19 20 01 19 19 06 06 06 00 20 20 20 20 00 00 06 06 00 20 19 19 19 19
19 19 20 00 00 20 19 06 06 06 00 02 00 00 00 02 00 06 06 00 00 19 19 19 19
19 19 00 01 00 00 20 06 06 06 06 06 00 00 01 00 00 06 06 00 00 20 20 20 19
19 19 00 02 01 00 06 06 06 06 06 06 06 06 06 06 06 06 06 06 06 06 06 06 19
19 19 00 00 06 06 06 06 06 06 06 06 06 06 06 06 06 06 06 06 06 00 23 06 19
19 19 18 06 06 06 06 18 18 18 18 18 06 06 00 18 18 18 18 00 06 22 00 06 19
19 19 19 06 06 06 18 19 19 19 19 19 06 06 00 19 19 19 19 00 06 06 06 06 19
19 19 19 06 06 18 19 19 19 19 19 19 06 06 00 19 19 19 19 00 00 00 00 18 19
19 19 19 06 06 19 19 19 19 19 19 19 06 06 00 19 19 19 19 18 18 18 18 19 19
19 19 19 06 06 19 19 19 19 19 19 19 06 06 00 19 19 19 19 19 19 19 19 19 19
19 19 19 06 06 19 19 19 19 19 19 19 06 06 06 20 19 19 19 19 19 19 19 19 19
19 19 19 06 06 19 19 19 19 19 19 19 18 06 06 06 20 19 19 19 19 19 19 19 19
19 19 20 06 06 20 19 20 19 20 20 19 20 18 06 06 00 19 19 19 19 19 19 19 19
19 19 06 06 00 00 20 00 20 00 00 20 00 20 06 06 00 19 19 19 19 19 19 19 19
19 20 06 06 00 00 00 00 23 00 00 00 00 06 06 06 00 19 19 19 19 19 19 19 19
19 06 06 02 00 01 00 21 00 00 06 06 06 06 06 06 00 19 19 19 19 19 19 19 19
19 06 06 01 01 02 00 22 00 06 06 06 06 06 06 06 00 19 19 19 19 19 19 19 19
19 06 06 00 02 02 18 00 06 06 06 18 18 18 06 06 18 19 19 19 19 19 19 19 19
19 18 06 06 00 00 19 18 06 06 18 19 19 19 06 06 19 19 19 19 19 19 19 19 19
19 19 06 06 00 18 19 19 06 06 19 19 19 19 06 06 20 19 19 19 19 19 19 19 19
19 19 18 18 18 19 19 19 06 06 19 19 19 19 18 06 06 20 19 19 19 19 19 19 19
19 19 19 19 19 19 19 19 06 06 20 20 20 19 19 06 06 00 19 19 19 19 19 19 19
19 19 19 19 19 19 19 19 06 06 06 06 06 20 20 06 06 00 19 19 19 19 19 19 19
19 19 19 19 19 19 19 19 18 06 06 06 06 06 06 06 06 00 19 19 19 19 19 19 19
19 19 19 19 19 19 19 19 19 18 18 06 06 06 06 06 00 00 19 19 19 19 19 19 19
19 19 19 19 19 19 19 19 19 19 19 00 06 06 06 00 00 00 19 19 19 19 19 19 19
19 19 19 19 19 19 19 19 19 19 19 00 06 06 06 00 00 18 19 19 19 19 19 19 19
19 19 19 19 19 19 19 19 19 19 19 00 06 06 06 00 18 19 19 19 20 20 19 19 19
19 19 19 19 19 19 19 19 19 19 19 00 06 06 06 06 20 20 20 20 00 00 19 19 19
19 19 19 19 19 19 19 19 19 19 19 00 00 06 06 06 06 06 06 06 06 00 19 19 19
19 19 19 19 19 19 19 19 19 19 19 00 00 06 06 06 06 06 06 06 06 00 19 19 19
19 19 19 19 19 19 19 19 19 19 19 18 00 00 00 06 06 06 06 06 06 00 19 19 19
19 19 19 19 19 19 19 19 19 19 19 19 00 00 00 01 00 00 00 02 00 01 19 19 19
19 19 19 19 19 19 19 19 19 19 19 19 18 00 00 00 00 02 00 01 18 18 19 19 19
19 19 19 19 19 19 19 19 19 19 19 19 19 18 18 18 18 18 18 18 19 19 18 19 19