25 50
19 19 19 19 19 19 19 19 19 19 19 19 19 19 19 19 19 19 19 19 19 19 19 19 19
19 19 19 19 19 19 19 19 19 19 19 19 19 19 19 19 19 19 19 19 19 19 19 19 19
19 19 19 19 19 19 19 19 19 19 19 19 19 19 19 19 19 19 20 20 20 19 19 19 19
19 19 19 19 19 20 20 20 20 19 19 19 19 19 19 19 19 19 06 06 06 19 19 19 19
19 19 19 20 20 03 03 03 03 20 19 19 19 19 19 19 19 19 06 06 06 19 19 19 19
19 19 19 03 03 03 04 03 03 03 20 19 19 19 19 19 19 19 06 06 06 19 20 20 19
19 20 20 03 03 03 03 03 03 03 03 20 20 20 19 19 19 19 06 06 06 20 03 03 20
20 03 03 03 03 03 03 03 05 03 03 03 03 03 20 19 19 20 24 24 24 03 03 03 03
03 03 03 03 03 03 03 03 03 03 04 03 03 03 03 20 20 03 24 24 24 03 04 03 03
03 03 03 03 03 03 03 03 03 03 03 03 03 03 04 03 03 03 24 24 24 03 03 03 03
03 03 03 03 03 18 00 03 03 03 03 03 05 03 03 03 03 03 24 24 24 03 03 05 03
03 03 03 03 00 20 00 00 00 03 03 03 03 03 03 03 05 03 24 24 24 03 03 03 03
03 03 03 03 00 00 01 00 18 00 03 03 03 03 03 03 03 03 24 24 24 05 03 03 03
03 03 00 18 00 00 02 18 20 00 03 03 25 25 25 25 25 25 25 25 25 03 03 03 04
03 03 00 20 00 18 00 20 00 00 04 03 25 25 25 25 25 25 25 25 25 03 03 03 03
03 03 04 00 00 20 00 01 00 03 03 03 24 24 03 03 05 03 03 03 03 03 03 03 03
03 03 03 00 18 00 01 02 03 03 03 03 24 24 03 03 03 03 03 03 03 03 03 03 03
03 03 03 03 20 03 03 03 03 03 03 04 24 24 03 03 03 04 03 03 05 03 03 03 03
03 05 03 03 03 03 03 05 03 03 03 03 24 24 03 03 03 03 03 03 03 03 04 03 03
03 03 03 03 03 03 03 03 03 03 03 03 24 24 05 03 03 03 03 03 03 03 03 03 03
03 03 03 03 05 03 03 03 03 03 03 03 24 24 03 03 03 03 03 04 03 03 03 05 03
03 03 03 03 03 03 03 25 25 25 25 25 25 25 25 25 25 25 25 25 03 03 03 03 03
03 03 04 03 03 03 03 25 25 25 25 25 25 25 25 25 25 25 25 25 03 05 03 03 03
03 03 03 03 03 04 03 24 24 03 03 03 03 03 03 03 03 03 24 24 03 03 03 03 03
03 05 03 03 03 03 03 24 24 03 00 00 00 03 03 03 03 03 24 24 03 03 03 03 03
03 03 03 03 03 03 03 24 24 03 01 00 00 18 03 03 03 03 24 24 03 03 03 03 03
03 03 03 03 03 03 03 24 24 03 00 18 01 20 00 03 03 03 24 24 03 03 04 03 03
03 03 03 03 04 03 03 24 24 03 00 20 00 02 00 03 03 03 24 24 03 03 03 03 03
03 03 03 03 03 03 03 24 24 03 02 00 01 00 03 03 03 03 24 24 03 03 03 03 05
03 03 05 03 03 03 03 24 24 03 03 03 03 03 03 03 03 03 24 24 03 03 03 03 03
03 03 03 03 03 03 03 24 24 03 03 03 03 03 03 03 03 03 24 24 03 04 03 03 03
03 03 03 03 03 03 03 25 25 25 25 25 25 25 25 25 25 25 25 25 03 03 03 03 03
03 03 03 03 03 03 03 25 25 25 25 25 25 25 25 25 25 25 25 25 03 03 05 03 03
03 03 03 03 03 03 03 03 03 05 24 24 03 04 03 03 03 03 03 03 03 03 03 03 18
03 03 03 03 05 03 03 03 03 03 24 24 03 03 03 03 03 04 03 03 03 03 18 18 19
03 03 04 03 03 03 03 03 04 03 24 24 03 03 03 05 03 03 18 18 18 18 19 19 19
03 03 03 03 03 03 03 03 03 03 24 24 03 18 18 18 18 18 19 19 19 19 19 19 19
03 03 03 03 03 04 03 03 18 18 06 06 18 19 19 19 19 19 19 19 19 19 19 19 19
03 05 03 03 18 18 18 18 19 19 06 06 19 19 19 19 19 19 19 19 19 19 19 19 19
03 03 18 18 19 19 19 19 19 19 06 06 19 19 19 19 19 19 19 19 19 19 19 19 19
18 18 19 19 19 19 19 19 19 20 06 06 20 19 19 19 19 19 19 19 19 19 19 19 19
19 19 19 19 19 19 19 19 19 01 06 06 00 19 19 19 19 19 19 19 19 19 19 19 19
19 19 19 19 19 19 19 19 19 01 06 06 00 19 19 19 19 19 19 19 19 19 19 19 19
19 19 19 19 19 19 19 19 20 00 06 06 02 20 19 19 19 19 19 19 19 19 19 19 19
19 19 19 19 19 19 19 19 02 00 06 06 00 00 19 19 19 19 19 19 19 19 19 19 19
19 19 19 19 19 19 19 19 01 01 06 06 00 00 19 19 19 19 19 19 19 19 19 19 19
19 19 19 19 19 19 19 20 00 00 06 06 00 01 20 19 19 19 19 19 19 19 19 19 19
19 19 19 19 19 19 19 00 01 00 00 00 00 00 00 19 19 19 19 19 19 19 19 19 19
19 19 19 19 19 19 19 18 18 18 18 18 18 18 18 19 19 19 19 19 19 19 19 19 19
19 19 19 19 19 19 19 19 19 19 19 19 19 19 19 19 19 19 19 19 19 19 19 19 19